NO ./more_textures/Skeletons.xpm
SO ./more_textures/Ghost.xpm
WE ./more_textures/Witch.xpm
EA ./more_textures/Darth.xpm


C 47,98,164
F 0,0,0

     1111111111111111111111            
   1110000000000000000000011           
  101110000111211110111100011          
 10000000010000000001000000011         
 10000000010000000001000000011         
 10000000010000000001000000011         
 1000000012111111110000000111          
 100000000000E0010100000011101       1 
 10110001111001110001111000111      101
 10000000000000000000000010001       1 
 10000000000000000000000000001         
 100000000000000000000000000001        
10000000000000000000000000000001       
10000000000000000000000000000001       
 100000000000000000000000000001        
 10000000000000000000000000001         
 10000000111111111110000000001         
 10000000200000000020000000111         
 11000000111111111110000000001         
 10000000000000000000000000001         
 10000000000000000000000000001         
 10000000000000000000000000001         
 11111111111111111111111111111         