NO ./textures/Skeletons.xpm
SO ./textures/Ghost.xpm
WE ./textures/Witch.xpm
EA ./textures/Darth.xpm


C 47,98,164
F 0,0,22

     1111111111111111111111            
   1110000000000000000000011           
  101110000111211110111100011          
 10000000010000000001000000011         
 10000000010000000001000000011         
 10000000010000000001000000011         
 1000000012111111110000000111          
 10000000000000010100000011101       1 
 10110001111001110001111000111      101
 10000000000000000000000010001       1 
 10000000000000000000000000001         
 100000000000000000000000000001        
10000000000002220000000000000001       
10000000000002020000000000000001       
 100000002000222000000000000001        
 10000000000000000000000000001         
 10000000111111111110000000001         
 10000000200000000020000000111         
 11000000111111111110000000001         
 10000000000000000000000000001         
 1000000000000000000000000001         
 100000000N0000000000000000001         
  111111111111111111111111111         