NO ./more_textures/WALL74.xpm
SO ./more_textures/WALL26.xpm
WE ./more_textures/WALL84.xpm
EA ./more_textures/WALL64.xpm


C 153,204,255
F 96,96,96

1111111111111111
1000000100000001
100000110000000
1100110000111011
1000000100000001
10000001000N0001
1111111111111111