NO ./more_textures/Skeletons.xpm
SO ./more_textures/Ghost.xpm
WE ./more_textures/Witch.xpm
EA ./more_textures/Darth.xpm


C 47,98,164
F 0,0,0

        1111111111111111111111111
        1000000000110000000000001
        1011000001110000000000001
        1001000000000000000000001
111111111011000001110000000000001
100000000011000001110111100111111
111101111111110111000000100011111
111101111111110111011110100011111
110000001101010111001 1010001
10000000000000001100111010001
10000000000000001101010010001    
11000001110101011111011110W0111  
11110111 1110101 101111010001  
11111111 1111111 111111111111    