NO ./textures_copy/door0.xpm
SO ./textures_copy/wood.xpm
WE ./textures_copy/greenlight.xpm
EA ./textures_copy/mossy.xpm


C 153,204,255
F 153,76,0

1111111111111111
1000000100000001
1000000100000001
1100110000111011
1000000100000001
10000001000N0001
1111111111111111